1111111111111111111111111
1P00000000000000100000001
1000000011111110100000001
1000000010000000100000001
1000000010111111100000001
1000000010000000000000001
1000000011111111100000001
1000000000000000100000001
10000000C0000000100000001
10000000000000001000C0001
10000C0000000000100000001
1000000000000000100000001
10000000000000001000000E1
1111111111000000100000001
1C00000000000000100000001
1111111111111111111111111